Year,Jan,Feb,Mar,Apr,May,Jun,Jul,Aug,Sep,Oct,Nov,Dec
1948,1511,1694,1614,1482,1245,1108,1195,1177,1146,981,1163,1344
1949,1923,2292,2267,2081,2154,2163,2547,2293,2115,2419,2108,2270
1950,2882,3041,2802,2429,1930,1779,1826,1443,1328,1074,1186,1343
1951,1522,1450,1216,995,859,919,954,878,862,856,928,914
1952,1230,1312,1152,1022,862,930,1062,1008,894,702,752,835
1953,1334,1188,1034,1070,894,822,886,768,814,788,1099,1529
1954,2068,2386,2444,2329,2099,1978,2015,1924,1885,1720,1739,1831
1955,2245,2248,2123,2013,1485,1381,1332,1236,1095,1118,1253,1433
1956,1788,1863,1824,1504,1428,1384,1340,1199,1122,1028,1281,1543
1957,1809,1810,1618,1521,1353,1402,1327,1258,1307,1337,1690,2062
1958,2759,3198,3318,3073,2804,2752,2779,2601,2190,2072,2132,2497
1959,2850,2926,2577,1933,1689,1659,1691,1650,1662,1630,2021,1970
1960,2417,2306,2454,2025,1740,1787,1863,1890,1703,1806,2085,2638
1961,3211,3363,3190,2773,2522,2330,2383,2275,1973,1880,2008,2309
1962,2591,2548,2458,2115,1807,1847,1803,1886,1621,1536,1826,2151
1963,2663,2787,2499,2066,1770,1745,1723,1683,1454,1466,1769,2023
1964,2406,2348,2148,1786,1467,1609,1510,1501,1378,1394,1395,1676
1965,2033,2108,1835,1586,1320,1317,1271,1279,1094,1023,1108,1249
1966,1529,1512,1403,1103,941,1049,1035,1035,871,839,971,1149
1967,1312,1310,1262,1069,955,1062,989,986,839,893,968,1069
1968,1319,1391,1219,969,843,997,921,913,816,810,844,873
1969,1142,1134,1048,901,810,905,945,886,914,906,909,1052
1970,1456,1678,1606,1498,1404,1585,1669,1625,1566,1641,1821,2115
1971,2553,2590,2379,2079,1914,2004,1994,2001,1842,1769,1939,2100
1972,2502,2478,2350,2071,1858,1921,1868,1759,1625,1667,1599,1684
1973,2026,2093,1957,1725,1558,1579,1484,1457,1343,1281,1396,1582
1974,2094,2226,2003,1855,1624,1744,1733,1805,1728,1863,2146,2665
1975,3719,3950,4009,3731,3518,3501,3418,3184,3141,3060,3184,3297
1976,3750,3723,3473,3057,2761,3035,2981,2818,2696,2710,2978,3196
1977,3611,3811,3386,2855,2637,2641,2587,2532,2221,2371,2387,2485
1978,2996,2979,2834,2347,2147,2097,2150,2090,1952,1979,2054,2309
1979,2693,2719,2596,2263,2010,2090,2217,2209,2046,2152,2272,2429
1980,3206,3182,3228,3322,3410,3507,3675,3547,3303,3210,3308,3345
1981,4066,4043,3881,3403,3400,3392,3221,3290,3145,3421,3773,4343
1982,5065,5108,5167,4851,4659,4905,4940,4877,4937,5137,5523,5896
1983,6481,6577,6239,5793,5437,5188,4922,4765,4510,4339,4365,4463
1984,4941,4743,4474,4181,3753,3639,3679,3560,3449,3382,3552,3831
1985,4391,4317,4112,3902,3505,3708,3571,3344,3302,3326,3487,3612
1986,4089,4361,4178,3791,3690,3674,3656,3345,3430,3456,3636,3706
1987,4297,4192,3941,3501,3319,3320,3187,2970,2783,2875,2999,3040
1988,3674,3578,3432,2938,2952,2784,2697,2803,2540,2618,2895,2934
1989,3485,3350,3019,2940,2602,2636,2614,2564,2658,2606,2887,2952
1990,3678,3541,3341,3196,2924,2896,2979,2982,3000,3053,3499,3776
1991,4494,4865,4723,4268,4008,4026,3986,3855,3836,3785,4078,4417
1992,5506,5568,5218,4748,4680,4676,4505,4385,4224,4233,4383,4478
1993,5197,5215,5033,4431,4203,4190,4119,3932,3763,3767,3703,3891
1994,4733,4699,4333,3780,3374,3367,3503,3335,3059,3098,3125,3125
1995,3958,3615,3550,3336,3212,3051,3077,3052,2957,2762,3100,3203
1996,3861,3834,3749,3328,3133,2964,3020,2665,2788,2641,2874,2901
1997,3736,3523,3435,2976,2582,2721,2653,2571,2556,2506,2504,2826
1998,3202,3055,3093,2453,2339,2437,2582,2359,2401,2278,2256,2510
1999,2908,3016,2597,2385,2331,2342,2400,2299,2208,2226,2148,2335
2000,2829,2886,2676,2242,2215,2175,2228,2165,2155,2202,2272,2466
2001,3109,3064,3117,2802,2634,2761,2782,2931,2845,3192,3492,3745
2002,4556,4364,4350,3917,3597,3707,3626,3550,3462,3579,3885,4163
2003,4895,4688,4528,4245,4072,4281,4119,3994,3850,3815,4058,3960
2004,4594,4402,4405,3746,3659,3620,3514,3470,3382,3393,3584,3727
2005,4218,4228,3909,3297,3149,3136,3073,3058,3132,2990,3163,3355
2006,3648,3765,3514,3177,3090,2917,3041,2955,2667,2725,2914,3158
2007,3845,3802,3480,3097,2985,3008,3131,2972,3039,3052,3095,3597
2008,4075,4013,4071,3584,3708,3829,4110,4171,4463,4598,4960,5984
2009,7185,7662,7842,7343,7511,7507,7427,7403,7437,7596,7611,8141
2010,9113,9072,8821,7895,7433,7428,7287,7211,7103,6899,7352,7545
2011,7986,7829,7581,6880,6796,6897,6734,6567,6427,6405,6195,6477
2012,6818,6834,6608,5829,5945,5998,5894,5700,5455,5457,5433,5836
2013,6678,6262,5941,5509,5559,5469,5421,5381,5297,5178,5058,5060
2014,5562,5645,5238,4512,4562,4440,4439,4366,3993,3843,4152,4267
2015,4815,4723,4411,3921,3965,3759,3779,3581,3523,3559,3637,3836
2016,4087,4158,4020,3628,3396,3536,3698,3487,3561,3527,3347,3656
2017,4068,4002,3752,3096,3004,3126,3199,3219,2972,2925,2909,3168
2018,3670,3501,3352,2983,2761,2972,2734,2731,2658,2694,2596,3066
2019,3635,3318,3308,2703,2594,2663,2723,2667,2488,2534,2506,2688
2020,3241,3212,3726,10338,9164,8201,7597,6376,5781,5245,5230,5305
2021,5562,5410,5120,0,0,0,0,0,0,0,0,0